1111111111111111111111111111111
1P000001000000000100000000000E1
1110111010111110101111111011101
1000000010100010000000010000001
1011111011101110111111011111101
1010000000001000000000010000101
1010111111101011111111010110101
1000100000100010000000010010001
1111101110111110111111111111101
1C00100000000000100000000000001
1011111111111101111111111111101
1000000000000000000000000000001
1111111111111111111111111111111
