11111111111111111111111111111111
10000000000000000000000000000001
10001000001001001111000001000001
10001000001001001000000010100001
10001000001001001000000111110001
10001111001111001111001000001001
10000000000000000000000000000011
1P00000000000C0000000000000001E1
11111111111111111111111111111111