11111111111111111111111111111111
10000000000000000000000000000001
10001000001001001111000010000001
10001000001001001000000101000001
10001000001001001000001111100001
10001111001111001111001000100001
10000000000000000000000000000001
1P00000000000C0000000000000001E1
11111111111111111111111111111111