11111111111111111111111111111111111
1P000000000000000000000000000000001
100110011001111100C0011110011111001
100110011000001100C0010000010001001
100111111001111100C0011110011111001
100000011001100000C0000010010000001
100000011001111100C0011110010000001
100000000000000000000000000000000E1
11111111111111111111111111111111111