111111111111111111
1P00000000000000E1
100110011001111001
100110011000011001
100111111001111001
100000011001100001
100000011001111001
1C0000000000000001
111111111111111111
